|____________________________________________________|
|                                                    |
|                                                    |
|                                                    |
|           %                                        |
|______________________________________________ _____|
|              -                                     |
|@                                                   |
|____________________________________________________|