|_________________________|
|                         |
|  %                      |
|                         |
|                         |
|_____________________ ___|
|-                        |
|@                        |
|_________________________|