|________________|
|% $*            |
|___|            |
|                |
|                |
|____________*___|
|-    -      #   |
|@      #     -  |
|________________|