|___________________|
|                   |
|  %                |
|                   |
|                   |
|_______________*___|
|-              #   |
|@ #                |
|___________________|