|_________________________|
|                         |
|  %                      |
|                         |
|                         |
|_____________________*___|
|-                        |
|@ #                      |
|_________________________|