|________________|
|                |
|  %             |
|                |
|                |
|____________*___|
|-           #   |
|@ #             |
|________________|