      _           
     |%|          
     |!|          
|____| |_________|
|#  -         -  |
|          -     |
|  -             |
|        #      -|
|____________ ___|
|-    -      #   |
|@  -   -     -  |
|________________|